NO textures/wood.xpm
EA textures/red_brick.xpm
SO textures/eagle.xpm
WE textures/grey_stone.xpm

C 255,255,0
F 0,0,255

        11111111111111111111111111111111111111111111111111111   1111111111111111111111111111111111111
       1110000000000000000000000000100000000000000001000000111111000000101000000010010000000000000001
11111111000000000000000000000000000000011111111110100000010000000000000101001000010110000000011110001
1000000001111111111111111111111111111111        1011111111001000111110000000100001011111110001  10001
1011110000000000000000010000000000000001        1000000000001000000011111100100001000000010001  10001
101  11100000000100010010000000100000001        10111111110010011000000011000000011111110111111110001
111   1000011001100010010000000100000001        10100000011110001111000011000100000000010100000000001
10111110000110001111100111000001000000011111111110100000000000000000000000000000000111110111011111111
10100000000110111010100110001111111000010000000000100000000001111111111111111111111100000100000000001
10000111111110101010100100101000000000010111111111100111111111                     101111101110000001
111001001001100000001001011010000000000100000000000001                             101000000100000001
10000000000111111111100101101000000000010111111111111111111111111111111111111111111101000010001100001
11111111111111111111100101101000000000010000000000000000000000000000000000000000000101000001111000001
1                   100101100000000000010000000000111111100000000100000001000000000101000001000000001
1              11111100101100011111111111111111110000000001110000100000001000000000100000001001111111
1              10000000100100000000000000100000010000000001000000101111111000000000100000001001     1
1              10011110100100000000000000100001011111100001101000101000001000000011100000000001     1
1111111111111111000001010011110100000000010000100000010000001110010100000100000001 100000001111     1
10000000000000000000010100101001000000000100001111100100111001000101000001000011111111110001        1
10000000000000000000010000101001000000000100000010000110000000000000000000000000000000000001111111111
10111111111111111111111000000011111000000100110010000110111001110011100111011110000000000000000000001
101010000001000010000000000000010100000000000000000001101 1101 1001 1101 1001 10000000001111110000001
101000100100010000010000001100010100010111111111111001101 1001 1101 1001 1101 10110100001    10010001
101000100111111111111111000000010100010000000000001001101 1011 1001 1001 1001 10000100001    10111001
10111000010000000000000000000001010001110001000100000000111001110011101111011110000100001111110010001
10101000010000111110000000000001010100011111100100000000000000000000000000000000000100000000000000001
101011110100001   11111111000000010101000001000100000000000111111111111111111111111111111111111101111
10100000000000111        100000111000111110000010000010000010000000000000000000000000001    100000001
10111110000000001111111111110000010001   10000010000000000010000000000001000000000000001    1000N0001
10000000000000000000000000000000000001   10000010000000000000000000000001000000000000001    100000001
11111111111111111111111111111111111111111111111111111111111111111111111111111111111111111111111111111
