NO textures/wood.xpm
EA textures/red_brick.xpm
SO textures/eagle.xpm
WE textures/grey_stone.xpm

C 255,255,0
F 0,0,255

111111111111111111111111111111111111
100000000000000000000000000111111111
111111111111111100000010000000000001
100000000000011111111111000000000011
100000000000000000000000000000000001
1000000000000001N0000000000000000001
100000000000000000000000000000000001
100000000010000000000000000000000101
111111111111111111111111111111111111
